
11111111111111111111111111111111111111111111111111111111111
100000000000000000000000000000000000000000000000000000000E1
10000000000000000000000000000011111100000000000010011100001
1000000000000000000001111000000000010000000C000010000000001
10000000000000000000000000000000000100010011111110000000001
1000000000000000C000000000000000000111110000000000000000001
10000000000000000000000000111111111100000000000000000000001
10000000000000000000000000100000000100000000000000000000001
10000000000000000000000000100000000000000000000000000000001
10000000000000000000000000101111110C00000000000000000000001
10000000000111000111110000000000000000000000000000000000001
10000000000000000000000001111111111111111111111111111111111
10000000000100000000010000010000000000000000000000000000001
10000000000111110111110000000000000000000000000000000000001
10000000000100000000010000000000000000000000000000000000001
10000000000100000000010000000000000000000000000000000000001
1000000000011001P100010000000000000000000000000000000000001
11111111111111111111111111111111111111111111111111111111111