1111111111111111111111111111111111111
1000000000000000000000000000000000001
1111111111111110000000000000000000001
100000000000CC10000000000111111111111
100000000000C010000000000000000000011
1000011111111110000000000000000000011
1000000P0000000000000000000000C000001
1000000000000000000000000000000000001
1000000000000000000000000000000000001
1000000011110000000000000000000C00001
1000000010000000000000000000000000001
100000001000000000001001000000C000001
10000000100000000000100100000000000E1
1111111111111111111111111111111111111