
11111111111111111111111111111111111111111111111111111111111
100000000000000000000000000000000000000000000000000000000E1
1000000000C00000C000000000000011111100000000000010011100001
1000000000000000C00001111000000000010000000C000010000000001
1000000X000000000000000000000000000000000000000000000000001
10000000000111110111110000000000000000000000000000000000001
1000000000010000000001000000000P000000000000000000000000001
1000000C0001000000000100000000000000X000000000000X000000001
1000000000011001C100010000000000000000000000000000000000011
11111111111111111111111111111111111111111111111111111111111
